6 6
S 1 1 1 1 1
1 X 1 2 1 1
1 1 1 2 1 1
1 1 1 2 1 1
1 1 1 1 1 G
1 1 1 X 1 1
