5 5
S 1 1 1 1
1 X X 1 1
1 1 1 X 1
1 X 1 1 1
1 1 1 1 G
