12 12
S 1 1 2 2 2 1 1 1 1 1 1
1 X 1 X 1 1 1 3 X 1 2 1
1 X 1 X 1 4 1 3 1 1 2 1
1 1 1 1 1 4 1 X 1 1 2 1
2 2 2 X 1 4 1 1 1 1 2 1
2 X 2 X 1 4 4 4 4 1 2 1
2 X 2 X 1 1 1 1 1 1 2 1
2 2 2 1 1 X X X 1 1 2 1
1 1 1 1 1 1 1 1 1 X 2 1
1 X X X X 1 1 1 1 1 2 1
1 1 1 1 1 1 1 1 1 1 2 1
1 1 1 1 1 1 1 1 1 1 1 G
