8 8
S 1 2 2 1 1 1 1
1 X 5 X 1 3 1 1
1 1 1 1 1 1 1 1
1 4 X X 1 2 X 1
1 1 1 1 1 1 1 1
1 X 3 3 3 X 1 1
1 1 1 X 1 1 1 1
1 1 1 1 1 1 1 G
